##### ####
#  #  #  #
#  # ##  #
# ##     #
#  ## ####
#        #
# ## ##  #
#  # ##  #
#  #  #  #
##### ####